#################################
#                     !         #
#       #          @@@          #
#       ####       @            #
#          #                    #
#   @      #      !     #       #
#   @@     @@           #       #
#          @@            @@@    #
#      !   #             @D@    #
#################################