#################################
#                               #
#       #          @@@          #
#       ####       @            #
#          #                    #
#   @      #            #       #
#   @@      @           #       #
#           @            @@@    #
#          #!            @D@    #
#################################