#################################
#                  @@@          #
#                  @@@        ! #
####   ############@@@###########
#                 #   #         #
#   @@            #   @@        #
####@@@           #   @@@       #
#              @  #   @@        #
# !          @@@  @   @       D #
#################################