#################################
#                               #
#       #          @@@          #
#       ####       @            #
#          #                    #
#   @      #            #       #
#   @@     @@           #       #
#          @@            @@@    #
#          #!            @D@    #
#################################