#################################
#                     !         #
#       #          @@@          #
#       ####       @            #
#       !  #                    #
#   @      #            #       #
#   @@     @@           #       #
#          @@            @@@    #
#          #      !      @D@    #
#################################