#########################################
#       #       @       #               #
#   #   @       #       @               #
#   #   #################  @#########   #
#   #   @@      @       @   #      @@ ! #
# ! #   @      @@       @@ !#D     @@   #
#########################################