#################################
#                  @@@          #
#                  @@@        ! #
####   ############@@@###########
#                 #   #         #
#   @@            #   @@    !   #
####@@@           #   @@@       #
#              @  #   @@        #
# !          @@@  @   @       D #
#################################