#################################
#  #       @      #       @     #
#  @       #      @       #     #
#  #################@#########  #
#  @@    @       @   #      @@ !#
#  @    @@       @@ !#D     @@  #
#################################