######################################################################
#                                                                    #
#                                                                    #
#   ##########################################################@@@#####
#   #                                                            #   #
#   #                                                            #   #
#   #############@@@#####   ##################################   #   #
#   #               #                              @         #   #   #
#   #               # @@                           @@        #   #   #
#   #   #####   #   ######################################   #   #   #
#   #   #       #       #               #                    #   #   #
#   #   #       #       #               #                    #   #   #
#   #   #################   #########   #   ##################   #   #
#   #   #       @       @   #      @@   #   #       #                #
#   #   #       @       @   #D     @@   #   #       #                #
# ! #   #   #############   #########   #   #   #   ##########   #   #
#   #   #   #           #               #   #   #                #   #
#   #   #   #           #               #   #   #                #   #
# ! #   #   #########   #################   #   ######################
#   #   #               #                   #              @         #
#   #   #               #                   #              @@        #
# ! #   #############   #############   #####   #   ##############   #
#   #               #   #                       #                #   #
#   #               #   #                       #                #   #
# ! #############   #@@@#   ######################################   #
#   #                                                                #
#   #                                                                #
######################################################################