#################################
#                     !         #
#       #          @@@          #
#       ####       @            #
# !        #                    #
#   @      #      !     #       #
#   @@     @@           #       #
#          @@            @@@    #
#          #             @D@    #
#################################